XXXXXXXXXXXXXXXXXXXXXXXXXXXXXXXXX
X###############################X
X#s/s/s//M//s/////////////H////#X
X#/s//////////////s//s///s/////#X
X#ss////s/s/ss///////s/////////#X
X#///ss/////////sss////s///////#X
X#s//###########################X
X#s/s#XXXXXXXXXXXXXXXXXXXXXXXXXXX
X#ss/#XXXXXXXXXXXXXXXXXXXXXXXXXXX
X#s//#XXXXXXXXXXXXXXXXXXXXXXXXXXX
X#///############################
X#//////////////////////////////>
X#//////////////////////////////>
X################################
XXXXXXXXXXXXXXXXXXXXXXXXXXXXXXXXX
XXXXXXXXXXXXXXXXXXXXXXXXXXXXXXXXX
XXXXXXXXXXXXXXXXXXXXXXXXXXXXXXXXX
XXXXXXXXXXXXXXXXXXXXXXXXXXXXXXXXX
XXXXXXXXXXXXXXXXXXXXXXXXXXXXXXXXX
XXXXXXXXXXXXXXXXXXXXXXXXXXXXXXXXX
XXXXXXXXXXXXXXXXXXXXXXXXXXXXXXXXX
XXXXXXXXXXXXXXXXXXXXXXXXXXXXXXXXX