XXXXXXXXXXXXXXXXXXXXXXXXXXXXXXXX
XXXXXXXXXXXXXXXXXXXXXXXXXXXXXXXX
XXXXXXXXXXXXXXXXXXXXXXXXXXXXXXXX
XXXXXXXXXXXXXXXXXXXXXXXXXXXXXXXX
XXXXXXXXXXXXXXXXXXXXXXXXXXXXXXXX
XXXXXXXX########################
XXXXXXXX#///M//////////////////>
XXXXXXXX#//////////////////////>
XXXXXXXX#//////////////////////>
XXXXXXXX#///////////////########
XXXXXXXX#////////M//////#XXXXXXX
XXXXXXXX#///////////////#XXXXXXX
XXXXXXXX#///////////////#XXXXXXX
XXXXXXXX#///////////////#XXXXXXX
XXXXXXXX#///////////////#XXXXXXX
#########////M//////////#XXXXXXX
</////////////////////M/#XXXXXXX
<///////////////////////#XXXXXXX
X########################XXXXXXX
XXXXXXXXXXXXXXXXXXXXXXXXXXXXXXXX
XXXXXXXXXXXXXXXXXXXXXXXXXXXXXXXX
XXXXXXXXXXXXXXXXXXXXXXXXXXXXXXXX
XXXXXXXXXXXXXXXXXXXXXXXXXXXXXXXX