XXXXXXXXXXXXXXXXXXXXXXXXXXXXXXXX
XXXXXXXXXXXXXXXXXXXXXXXXXXXXXXXX
XXXXXXXXXXXXXXXXXXXXXXXXXXXXXXXX
XXXXXXXXXXXXXXXXXXXXXXXXXXXXXXXX
XXXXXXXXXXXXXXXXXXXXXXXXXXXXXXXX
XXXXXXXXXXXXXXXXXXXXXXXXXXXXXXXX
XXXXXXXXX#############XXXXXXXXXX
XXXXXXXXX#///////////#XXXXXXXXXX
XXXXXXXXX#///C///C///#XXXXXXXXXX
XXXXXXXXX#///////////#XXXXXXXXXX
XXXXXXXXX#///////////#XXXXXXXXXX
XXXXXXXXX#///////////#XXXXXXXXXX
XXXXXXXXX#///////////#XXXXXXXXXX
XXXXXXXXX#///////////#XXXXXXXXXX
XXXXXXXXX#///////////#XXXXXXXXXX
XXXXXXXXX#///////////#XXXXXXXXXX
XXXXXXXXX#///////////#XXXXXXXXXX
XXXXXXXXX#/////+/////#XXXXXXXXXX
XXXXXXXXX#############XXXXXXXXXX
XXXXXXXXXXXXXXXXXXXXXXXXXXXXXXXX
XXXXXXXXXXXXXXXXXXXXXXXXXXXXXXXX
XXXXXXXXXXXXXXXXXXXXXXXXXXXXXXXX